20
14
####################
#       F# # #   # #
# ########     # # #
# # ## #   # # #   #
# # #    # ##### # #
# #   ####S    #####
# ######## # #  ## #
# # #    # # ##  # #
#     ## # #  # ## #
# ##### ## #### ## #
# #  #  ## #  # #  #
#   ## ### #### ## #
###                #
####################
